+---------------------------------------+
|                                       |
| + + + + + + + + + + + + + + + + + + + |
|                                       |
| + + + + + + + + + + + + + + + + + + + |
|                                       |
| + + + + + + + + + + + + + + + + + + + |
|                                       |
| + + + + + + + + + + + + + + + + + + + |
|                                       |
| + + + + + + + + + + + + + + + + + + + |
|                                       |
| + + + + + + + + + + + + + + + + + + + |
|                                       |
| + + + + + + + + + + + + + + + + + + + |
|                                       |
| + + + + + + + + + + + + + + + + + + + |
|                                       |
| + + + + + + + + + + + + + + + + + + + |
|                                       |
+---------------------------------------+
